EP	EP
a	a
ai	ai
an	an
ang	ang
ao	ao
ba	b a
bai	b ai
ban	b an
bang	b ang
bao	b ao
be	b e
bei	b ei
ben	b en
beng	b eng
ber	b er
bi	b i
bia	b ia
bian	b ian
biang	b iang
biao	b iao
bie	b ie
bin	b in
bing	b ing
biong	b iong
biu	b iu
bo	b o
bong	b ong
bou	b ou
bu	b u
bua	b ua
buai	b uai
buan	b uan
buang	b uang
bui	b ui
bun	b un
bv	b v
bve	b ve
ca	c a
cai	c ai
can	c an
cang	c ang
cao	c ao
ce	c e
cei	c ei
cen	c en
ceng	c eng
cer	c er
cha	ch a
chai	ch ai
chan	ch an
chang	ch ang
chao	ch ao
che	ch e
chei	ch ei
chen	ch en
cheng	ch eng
cher	ch er
chi	ch ir
chong	ch ong
chou	ch ou
chu	ch u
chua	ch ua
chuai	ch uai
chuan	ch uan
chuang	ch uang
chui	ch ui
chun	ch un
chuo	ch uo
chv	ch v
chyi	ch i
ci	c i0
cong	c ong
cou	c ou
cu	c u
cua	c ua
cuai	c uai
cuan	c uan
cuang	c uang
cui	c ui
cun	c un
cuo	c uo
cv	c v
cyi	c i
da	d a
dai	d ai
dan	d an
dang	d ang
dao	d ao
de	d e
dei	d ei
den	d en
deng	d eng
der	d er
di	d i
dia	d ia
dian	d ian
diang	d iang
diao	d iao
die	d ie
din	d in
ding	d ing
diong	d iong
diu	d iu
dong	d ong
dou	d ou
du	d u
dua	d ua
duai	d uai
duan	d uan
duang	d uang
dui	d ui
dun	d un
duo	d uo
dv	d v
dve	d ve
e	e
ei	ei
en	en
eng	eng
er	er
fa	f a
fai	f ai
fan	f an
fang	f ang
fao	f ao
fe	f e
fei	f ei
fen	f en
feng	f eng
fer	f er
fi	f i
fia	f ia
fian	f ian
fiang	f iang
fiao	f iao
fie	f ie
fin	f in
fing	f ing
fiong	f iong
fiu	f iu
fo	f o
fong	f ong
fou	f ou
fu	f u
fua	f ua
fuai	f uai
fuan	f uan
fuang	f uang
fui	f ui
fun	f un
fv	f v
fve	f ve
ga	g a
gai	g ai
gan	g an
gang	g ang
gao	g ao
ge	g e
gei	g ei
gen	g en
geng	g eng
ger	g er
gi	g i
gia	g ia
gian	g ian
giang	g iang
giao	g iao
gie	g ie
gin	g in
ging	g ing
giong	g iong
giu	g iu
gong	g ong
gou	g ou
gu	g u
gua	g ua
guai	g uai
guan	g uan
guang	g uang
gui	g ui
gun	g un
guo	g uo
gv	g v
gve	g ve
ha	h a
hai	h ai
han	h an
hang	h ang
hao	h ao
he	h e
hei	h ei
hen	h en
heng	h eng
her	h er
hi	h i
hia	h ia
hian	h ian
hiang	h iang
hiao	h iao
hie	h ie
hin	h in
hing	h ing
hiong	h iong
hiu	h iu
hong	h ong
hou	h ou
hu	h u
hua	h ua
huai	h uai
huan	h uan
huang	h uang
hui	h ui
hun	h un
huo	h uo
hv	h v
hve	h ve
ji	j i
jia	j ia
jian	j ian
jiang	j iang
jiao	j iao
jie	j ie
jin	j in
jing	j ing
jiong	j iong
jiu	j iu
ju	j v
juan	j van
jue	j ve
jun	j vn
ka	k a
kai	k ai
kan	k an
kang	k ang
kao	k ao
ke	k e
kei	k ei
ken	k en
keng	k eng
ker	k er
ki	k i
kia	k ia
kian	k ian
kiang	k iang
kiao	k iao
kie	k ie
kin	k in
king	k ing
kiong	k iong
kiu	k iu
kong	k ong
kou	k ou
ku	k u
kua	k ua
kuai	k uai
kuan	k uan
kuang	k uang
kui	k ui
kun	k un
kuo	k uo
kv	k v
kve	k ve
la	l a
lai	l ai
lan	l an
lang	l ang
lao	l ao
le	l e
lei	l ei
len	l en
leng	l eng
ler	l er
li	l i
lia	l ia
lian	l ian
liang	l iang
liao	l iao
lie	l ie
lin	l in
ling	l ing
liong	l iong
liu	l iu
lo	l o
long	l ong
lou	l ou
lu	l u
lua	l ua
luai	l uai
luan	l uan
luang	l uang
lui	l ui
lun	l un
luo	l uo
lv	l v
lve	l ve
ma	m a
mai	m ai
man	m an
mang	m ang
mao	m ao
me	m e
mei	m ei
men	m en
meng	m eng
mer	m er
mi	m i
mia	m ia
mian	m ian
miang	m iang
miao	m iao
mie	m ie
min	m in
ming	m ing
miong	m iong
miu	m iu
mo	m o
mong	m ong
mou	m ou
mu	m u
mua	m ua
muai	m uai
muan	m uan
muang	m uang
mui	m ui
mun	m un
mv	m v
mve	m ve
na	n a
nai	n ai
nan	n an
nang	n ang
nao	n ao
ne	n e
nei	n ei
nen	n en
neng	n eng
ner	n er
ni	n i
nia	n ia
nian	n ian
niang	n iang
niao	n iao
nie	n ie
nin	n in
ning	n ing
niong	n iong
niu	n iu
nong	n ong
nou	n ou
nu	n u
nua	n ua
nuai	n uai
nuan	n uan
nuang	n uang
nui	n ui
nun	n un
nuo	n uo
nv	n v
nve	n ve
o	o
ong	ong
ou	ou
pa	p a
pai	p ai
pan	p an
pang	p ang
pao	p ao
pe	p e
pei	p ei
pen	p en
peng	p eng
per	p er
pi	p i
pia	p ia
pian	p ian
piang	p iang
piao	p iao
pie	p ie
pin	p in
ping	p ing
piong	p iong
piu	p iu
po	p o
pong	p ong
pou	p ou
pu	p u
pua	p ua
puai	p uai
puan	p uan
puang	p uang
pui	p ui
pun	p un
pv	p v
pve	p ve
qi	q i
qia	q ia
qian	q ian
qiang	q iang
qiao	q iao
qie	q ie
qin	q in
qing	q ing
qiong	q iong
qiu	q iu
qu	q v
quan	q van
que	q ve
qun	q vn
ra	r a
rai	r ai
ran	r an
rang	r ang
rao	r ao
re	r e
rei	r ei
ren	r en
reng	r eng
rer	r er
ri	r ir
rong	r ong
rou	r ou
ru	r u
rua	r ua
ruai	r uai
ruan	r uan
ruang	r uang
rui	r ui
run	r un
ruo	r uo
rv	r v
ryi	r i
sa	s a
sai	s ai
san	s an
sang	s ang
sao	s ao
se	s e
sei	s ei
sen	s en
seng	s eng
ser	s er
sha	sh a
shai	sh ai
shan	sh an
shang	sh ang
shao	sh ao
she	sh e
shei	sh ei
shen	sh en
sheng	sh eng
sher	sh er
shi	sh ir
shong	sh ong
shou	sh ou
shu	sh u
shua	sh ua
shuai	sh uai
shuan	sh uan
shuang	sh uang
shui	sh ui
shun	sh un
shuo	sh uo
shv	sh v
shyi	sh i
si	s i0
song	s ong
sou	s ou
su	s u
sua	s ua
suai	s uai
suan	s uan
suang	s uang
sui	s ui
sun	s un
suo	s uo
sv	s v
syi	s i
ta	t a
tai	t ai
tan	t an
tang	t ang
tao	t ao
te	t e
tei	t ei
ten	t en
teng	t eng
ter	t er
ti	t i
tia	t ia
tian	t ian
tiang	t iang
tiao	t iao
tie	t ie
tin	t in
ting	t ing
tiong	t iong
tong	t ong
tou	t ou
tu	t u
tua	t ua
tuai	t uai
tuan	t uan
tuang	t uang
tui	t ui
tun	t un
tuo	t uo
tv	t v
tve	t ve
wa	w a
wai	w ai
wan	w an
wang	w ang
wao	w ao
we	w e
wei	w ei
wen	w en
weng	w eng
wer	w er
wi	w i
wo	w o
wong	w ong
wou	w ou
wu	w u
xi	x i
xia	x ia
xian	x ian
xiang	x iang
xiao	x iao
xie	x ie
xin	x in
xing	x ing
xiong	x iong
xiu	x iu
xu	x v
xuan	x van
xue	x ve
xun	x vn
ya	y a
yai	y ai
yan	y En
yang	y ang
yao	y ao
ye	y E
yei	y ei
yi	y i
yin	y in
ying	y ing
yo	y o
yong	y ong
you	y ou
yu	y v
yuan	y van
yue	y ve
yun	y vn
ywu	y u
za	z a
zai	z ai
zan	z an
zang	z ang
zao	z ao
ze	z e
zei	z ei
zen	z en
zeng	z eng
zer	z er
zha	zh a
zhai	zh ai
zhan	zh an
zhang	zh ang
zhao	zh ao
zhe	zh e
zhei	zh ei
zhen	zh en
zheng	zh eng
zher	zh er
zhi	zh ir
zhong	zh ong
zhou	zh ou
zhu	zh u
zhua	zh ua
zhuai	zh uai
zhuan	zh uan
zhuang	zh uang
zhui	zh ui
zhun	zh un
zhuo	zh uo
zhv	zh v
zhyi	zh i
zi	z i0
zong	z ong
zou	z ou
zu	z u
zua	z ua
zuai	z uai
zuan	z uan
zuang	z uang
zui	z ui
zun	z un
zuo	z uo
zv	z v
zyi	z i
CL	cl
cl	cl
a_/.	a_/.
i_/.	i_/.
u_/.	u_/.
e_/.	e_/.
o_/.	o_/.
ka_/.	k_/. a_/.
ki_/.	k_/. i_/.
ku_/.	k_/. u_/.
ke_/.	k_/. e_/.
ko_/.	k_/. o_/.
sa_/.	s_/. a_/.
shi_/.	sh_/. i_/.
su_/.	s_/. u_/.
se_/.	s_/. e_/.
so_/.	s_/. o_/.
ta_/.	t_/. a_/.
ti_/.	ch_/. i_/.
chi_/.	ch_/. i_/.
tsu_/.	ts_/. u_/.
te_/.	t_/. e_/.
to_/.	t_/. o_/.
na_/.	n_/. a_/.
ni_/.	n_/. i_/.
nu_/.	n_/. u_/.
ne_/.	n_/. e_/.
no_/.	n_/. o_/.
ha_/.	h_/. a_/.
hi_/.	h_/. i_/.
hu_/.	h_/. u_/.
fu_/.	f_/. u_/.
he_/.	h_/. e_/.
ho_/.	h_/. o_/.
ma_/.	m_/. a_/.
mi_/.	m_/. i_/.
mu_/.	m_/. u_/.
me_/.	m_/. e_/.
mo_/.	m_/. o_/.
ya_/.	y_/. a_/.
yu_/.	y_/. u_/.
yo_/.	y_/. o_/.
ra_/.	r_/. a_/.
ri_/.	r_/. i_/.
ru_/.	r_/. u_/.
re_/.	r_/. e_/.
ro_/.	r_/. o_/.
wa_/.	w_/. a_/.
wo_/.	w_/. o_/.
n_/.	N_/.
ga_/.	g_/. a_/.
gi_/.	g_/. i_/.
gu_/.	g_/. u_/.
ge_/.	g_/. e_/.
go_/.	g_/. o_/.
za_/.	z_/. a_/.
zi_/.	j_/. i_/.
ji_/.	j_/. i_/.
zu_/.	z_/. u_/.
ze_/.	z_/. e_/.
zo_/.	z_/. o_/.
da_/.	d_/. a_/.
di_/.	d_/. i_/.
du_/.	d_/. u_/.
de_/.	d_/. e_/.
do_/.	d_/. o_/.
ba_/.	b_/. a_/.
bi_/.	b_/. i_/.
bu_/.	b_/. u_/.
be_/.	b_/. e_/.
bo_/.	b_/. o_/.
pa_/.	p_/. a_/.
pi_/.	p_/. i_/.
pu_/.	p_/. u_/.
pe_/.	p_/. e_/.
po_/.	p_/. o_/.
kya_/.	ky_/. a_/.
kyu_/.	ky_/. u_/.
kyo_/.	ky_/. o_/.
gya_/.	gy_/. a_/.
gyu_/.	gy_/. u_/.
gyo_/.	gy_/. o_/.
sha_/.	sh_/. a_/.
shu_/.	sh_/. u_/.
sho_/.	sh_/. o_/.
ja_/.	j_/. a_/.
ju_/.	j_/. u_/.
jo_/.	j_/. o_/.
cha_/.	ch_/. a_/.
chu_/.	ch_/. u_/.
cho_/.	ch_/. o_/.
nya_/.	ny_/. a_/.
nyu_/.	ny_/. u_/.
nyo_/.	ny_/. o_/.
hya_/.	hy_/. a_/.
hyu_/.	hy_/. u_/.
hyo_/.	hy_/. o_/.
mya_/.	my_/. a_/.
myu_/.	my_/. u_/.
myo_/.	my_/. o_/.
rya_/.	ry_/. a_/.
ryu_/.	ry_/. u_/.
ryo_/.	ry_/. o_/.
tya_/.	ty_/. a_/.
tyu_/.	ty_/. u_/.
tyo_/.	ty_/. o_/.
あ	a_/.
い	i_/.
う	u_/.
え	e_/.
お	o_/.
を	o_/.
か	k_/. a_/.
き	k_/. i_/.
く	k_/. u_/.
け	k_/. e_/.
こ	k_/. o_/.
さ	s_/. a_/.
し	sh_/. i_/.
す	s_/. u_/.
せ	s_/. e_/.
そ	s_/. o_/.
た	t_/. a_/.
ち	ch_/. i_/.
つ	ts_/. u_/.
て	t_/. e_/.
と	t_/. o_/.
な	n_/. a_/.
に	n_/. i_/.
ぬ	n_/. u_/.
ね	n_/. e_/.
の	n_/. o_/.
は	h_/. a_/.
ひ	h_/. i_/.
ふ	f_/. u_/.
へ	h_/. e_/.
ほ	h_/. o_/.
ま	m_/. a_/.
み	m_/. i_/.
む	m_/. u_/.
め	m_/. e_/.
も	m_/. o_/.
や	y_/. a_/.
ゆ	y_/. u_/.
よ	y_/. o_/.
ら	r_/. a_/.
り	r_/. i_/.
る	r_/. u_/.
れ	r_/. e_/.
ろ	r_/. o_/.
わ	w_/. a_/.
を	w_/. o_/.
ん	N_/.
が	g_/. a_/.
ぎ	g_/. i_/.
ぐ	g_/. u_/.
げ	g_/. e_/.
ご	g_/. o_/.
ざ	z_/. a_/.
じ	j_/. i_/.
ず	z_/. u_/.
ぜ	z_/. e_/.
ぞ	z_/. o_/.
だ	d_/. a_/.
で	d_/. e_/.
ど	d_/. o_/.
ば	b_/. a_/.
び	b_/. i_/.
ぶ	b_/. u_/.
べ	b_/. e_/.
ぼ	b_/. o_/.
ぱ	p_/. a_/.
ぴ	p_/. i_/.
ぷ	p_/. u_/.
ぺ	p_/. e_/.
ぽ	p_/. o_/.
きゃ	ky_/. a_/.
きゅ	ky_/. u_/.
きょ	ky_/. o_/.
ぎゃ	gy_/. a_/.
ぎゅ	gy_/. u_/.
ぎょ	gy_/. o_/.
しゃ	sh_/. a_/.
しゅ	sh_/. u_/.
しょ	sh_/. o_/.
じゃ	j_/. a_/.
じゅ	j_/. u_/.
じょ	j_/. o_/.
ちゃ	ch_/. a_/.
ちゅ	ch_/. u_/.
ちょ	ch_/. o_/.
にゃ	ny_/. a_/.
にゅ	ny_/. u_/.
にょ	ny_/. o_/.
ひゃ	hy_/. a_/.
ひゅ	hy_/. u_/.
ひょ	hy_/. o_/.
みゃ	my_/. a_/.
みゅ	my_/. u_/.
みょ	my_/. o_/.	
りゃ	ry_/. a_/.
りゅ	ry_/. u_/.
りょ	ry_/. o_/.
_m	_m
.b	.b
.d	.d
.g	.g
huanr	h uanr
quanr	q uanr
zuanr	z uanr
chuanr	ch uanr
shuanr	sh uanr
luanr	l uanr
guanr	g uanr
kuanr	k uanr
juanr	j uanr
xuanr	x uanr
liar	l iar
niar	n iar
biar	b iar
miar	m iar
diar	d iar
tiar	t iar
piar	p iar
qiar	q iar
jiar	j iar
